R    1500 1000
S ./textures/tonneau.xpm
NO ./textures/bluestone.xpm
SO ./textures/wall_3.xpm
WE ./textures/wall_4.xpm
EA ./textures/wall_1.xpm
F      192,192,192
F      192,192,192


C 0,128,128

   1111111111111111111111111   
   1000000000111 100000000001
   1011000001110100020000011
   100100000000000000000000111111111
111111111011000001110000000000001
100000000011000001110111111111111
11110111111111011100000010001
11110111111111011101010010001
11000000110101011100000010001
1000200000000000110N000012001
10000000000000000001010000001
1100000111010101100101111000111
11110111 1110101 101111010001
11111111 1111111 111111111111







